-----------------------------------------------------------------------------------------------------------------------------------------------------------------------------------------------------------oo----------------------------------------------
-----------------------------------------------------------------------------------------------------------------------------------------------------------------------------------------------------------oo----------------------------------------------
-----------------------------------------------------------------------------------------------------------------------------------------------------------------------------------------------------------oo----------------------------------------------
-----------------------------------------------------------------------------------------------------------------------------------------------------------------------------------------------------------oo----------------------------------------------
-----------------------------------------------------------------------------------------------------------------------------------------------------------------------------------------------------------oo----------------------------------------------
-----------------------------------------------------------------------------------------------------------------------------------------------------------------------------------------------------------oo--------------------oo------------------------
---------------------------------------------------------------------------------------------------------------------------------------------------------------------------------------------------------------------------------##------------------------
---------------------------------------------------------------------------------------------------------------------------------------------------------------------------------------------------------------------B-------------------------------------
-------------------------------------------------------------------------------------------------------------------------------------------------------------------@-------------------------------------------------b-------------------------------------
--------------------------o-----------------------------------------------B-------------------------------------------------##-----------------------------------------------------------------------------------BXXXXXXXXXX----------BB-------------------
-------------------------o-o--------g------------------------------------gb------------------@!!----XXX-------------@-------------------------------------oo-----------------B-----------------------------------bXXXXXXXXXXXXX-------BB-------------------
---------------@-------------------S@S--------------B-----!------------XXXX-----------XXX-----------XXX-------------------------------------XXXXXg-------o-------------------b--------B----------------------BXXXXXXXXXXXXXXXXX-----ooBB----##-------------
----------------------------------------------------b----------------gXXXXX---XXXXX---XXX-----------XXX--------XXX-----XXX------------------XXXXXX----------XXXXXXXXXXXXXXXXXXXX------b----------------------bXXXXXXXXXXXXXXXXX-------BB-------------------
---------------------------------------------B------b-------------XXXXXXXXX---XXXXX---XXX-----------XXX-------XXXX-----XXXX-------------B---XXXXXXXg--------XXXXXXXXXXXXXXXXXXXXX-----b--------B----------XXXXXXXXXXXXXXXXXXXXXX-oo--XXXX------------------
--------------------g-XXX---XXX--------------b----g-b-----------gXXXXXXXXXX---XXXXX---XXX---XXXXX---XXX----XXXXXXX-#-#-XXXXXXX----------b---XXXXXXXX---g----XXXXXXXXXXXXXXXXXXXXXX----b--------b----------XXXXXXXXXXXXXXXXXXXXXX-oo--XXXX------------F-----
XXXXXXXXXXXXXXXXXXXXXXXXX---XXXXXXXXXXXXXXX--XXXXXXXX----XXXXXXXXXXXXXXXXXX---XXXXX---XXX---XXXXX---XXX----XXXXXXX-----XXXXXXX---XXXX---b---XXXXXXXXXXXXX---XXXXXXXXXXXXXXXXXXXXXXXXXXXXXXXX---XXXXXXXXXXXXXXXXXXXXXXXXXXXXXXXXX-XX--XXXXXX------XXXXXXXXXX